
   
WE   ./assets/textures/bricks.png
NO ./assets/textures/concrete.png

         
EA       ./assets/textures/wood_blue_old.png
SO ./assets/textures/skulls.png
   
    
F 255,100,0
  
C 225,222,0

          1111111111111111111111111
          1000000000110000000000001
          10110000011100000000000011    
          1001000000000000000000001
    111111111011000001110000000000001
    100000000011000001110111111111111    
    11110111111111011100000010001             
   111110111111111011101010010001
  1111000000110101011100000010001
    10000000000000001100000010001
  1110000000000000001101010010001      
    11000001110101011111011110N0111
    11110111 1110101 101111010001
    11111111 1111111 111111111111

                
     
