
   
WE   ./assets/textures/bricks.png
   		NO ./assets/textures/concrete.png      

				

	
EA       ./assets/textures/wood_blue_old.png   
SO ./assets/textures/skulls.png
   
    
F 255,100,0   
  
	C 225,222,0

            11111111111111111111111
          1110000000001100000000001       
            10110000011100000000001
            1001000000000000000000111   
    111111111011000001110000000000001
    100000000011000001110111111111111
    11110111N11111011100000100011111            
    11111111011111111101110101001001
    11000000110101011100000010001111
   110000000000000001100000010001
    10000000000000001101010010001         
    1100000111010101111101111000111
    11110111 1110101 101111010001
    11111111 1111111 1111 1111111
        11111111    
       111000011  
        1110011
        11100111      
       11000001  
       111011111
         111
                
     
