
   
WE   ./assets/textures/bricks.png
   		NO ./assets/textures/concrete.png      

				

	
EA       ./assets/textures/wood_blue_old.png   
SO ./assets/textures/skulls.png
   
    
F 139,131,255   
  
	C 225,162,162

            1111111111111111111
            1000000000110000001       
            1011000001110000001
            100100S0000000000111   
    1111111110110000011100000001
    1000000000110000011101111111
    10111111011111011100000101111           
    10000000011111001110101001001
    11101111110101011100000010001
    10000000000000001100000010001
    10000000000000000001010010001         
    11000001111111011111011110001
    11110101 1000001 101111010001
    11111101 1011111 1111 1111111
        11011101    
        11000001  
        11100111
        11100111      
        1000001  
        1101111
         111
                
     
