
   
WE   ./assets/textures/bricks.png
   		NO ./assets/textures/concrete.png      

				

	
EA       ./assets/textures/wood_blue_old.png   
SO ./assets/textures/skulls.png
   
    
F 255,100,0   
  
	C 225,222,0

            11111111111111111111111
          1110000000001100000000001       
            10110000011100000001001
            1001000000000000000100111   
    111111111011000001110000001100001
    100000000011000001110000010111111
    1111011111111101110000E010011111            
    11111111011111111101110000111001 
    11000000110101011100000000011111
   110000000000000001100000010011
    10000000000000001101010010011         
    1100000111010101111101111000111
    11110111 1110101 101111010001
    11111111 1111111 1111 1111111
        11111111    
       111000011  
        1110011
        11100111      
       11000001  
       111011111
         111
                
     
